,sequence,bpos1,bpos2,distance,num_1mer,num_2mer,num_3mer,label
0,GGTATACATGTGTCCACAAACACACATGCACACACA,9,25,16,4,11,19,cooperative
1,CCAAGCCCGCGTGCAGCCCACCTCGTGGGGTGTCTC,10,24,14,4,12,25,cooperative
2,AGCACGCACGCGCGGAGGTTCGCACGCGGAGAAGGG,9,25,16,4,11,17,cooperative
3,CCCCACTTGCCACATGTAAACCACATGCTTCTGCCA,13,24,11,4,12,21,cooperative
4,ACGCCCACATGCCCCTCCCCGTCCACGTGGACACGG,8,26,18,4,12,20,cooperative
5,CCCCGGACAACGTGCGCCGTCACGTGACGGCAGAGC,11,23,12,4,12,24,cooperative
6,CGAGTAGCATGTGCGGGAGACTCACGTTGCCGGCGA,10,25,15,4,15,29,cooperative
7,AGAACAGCATGTGCTAAGGACCATGCTTGCAGAGCC,10,24,14,4,14,24,cooperative
8,CAGCACCCGCGTGTTCCCCCATCACGTGCTCAGAGG,10,25,15,4,13,25,cooperative
9,GGCGCCTCCACGCGGAACCCCACGCGGCGCTCAGCA,11,23,12,4,11,20,cooperative
10,GGTACAGCGCGTGTGGGGCGCCCCCACGTGGTCAAG,10,27,17,4,12,22,cooperative
11,GGGGAGACGTGCACGCGCGCGCGCGTGCGTGCAAGC,14,24,10,4,10,15,cooperative
12,CCCCCTCCCCATGCGCGGCGCCCATGCGGACTGAGC,12,25,13,4,12,19,cooperative
13,GTTGAGCACGTGTAAACCAGGCCACGTGCTTACAGA,9,25,16,4,14,27,cooperative
14,GCTGAGCCACGTTGAGTAAATGCATGTGCACGGTCA,10,25,15,4,16,26,cooperative
15,ACGATGCGCCGCATGGACACCACGTTGTCGGGCACG,12,23,11,4,12,27,cooperative
16,CTTAGAGAACACGCGATGACCACGTGGAGCCTCCGG,10,23,13,4,16,29,cooperative
17,CCGCCCATGCCACGCCCCGCCACGCGTGCGCTTAGG,13,25,12,4,12,17,cooperative
18,GAGCCATCAGCATGGTGACCCATGTGGACAAGCTTA,11,23,12,4,14,24,cooperative
19,CCCCTCAGCGCATGGGTGGCGGTCACGTGCCCAGAA,11,26,15,4,13,25,cooperative
20,CCTCTGCACGTGGCCTCCTTCCCGCGTGCACGCCAC,9,25,16,4,11,21,cooperative
21,CGCCCCCTCGTGGTGGAGGCGGGCACGTGCCGGGCA,9,26,17,4,12,22,cooperative
22,ATGAACCTGCATGTGTGTGTCATGTGGGAAGGGAAC,12,23,11,4,13,19,cooperative
23,GATTCCTGCACGTGTTCGCCCACATGATGATGAAGC,11,23,12,4,14,25,cooperative
24,GTGAACACATGGTTATCAAGAGGCACATGCTCTTAC,8,26,18,4,14,27,cooperative
25,GGGGCCGCACGTGCTGCGCCTGCGCGTGGAGCGGAC,10,25,15,4,11,20,cooperative
26,AGTCAGTGACACGTTTTCACCCACATGTCAGTACAG,12,24,12,4,12,22,cooperative
27,ATTGTCTAACACGTGTGACCGCATGGATGGTGTCCT,12,22,10,4,15,26,cooperative
28,CCCTGCATGTGGGAAACACAGGTCCACGTGCAAGAC,8,27,19,4,14,28,cooperative
29,CCCGAAACCGCGTGTGCGCGCACGTGTCCCCGCGAT,13,23,10,4,10,18,cooperative
30,GCTGGGCCTCGTGGGCGCGTTCCGCGTGGGTTCTGG,10,25,15,3,9,19,cooperative
31,CCCTCCGCACATGGTGCGAGCCATGCGCGGGGCGTG,10,24,14,4,13,25,cooperative
32,GGCCACCCCCACATGTCCCCATGTGTGTAAAACATA,12,22,10,4,11,17,cooperative
33,CCTAAAGCATGGCAGGAAAGCAAACATGTGGCTTTT,8,27,19,4,14,23,cooperative
34,AGGCTTTCACGTGTGTCATCTCACGTGATCTTCTGG,10,24,14,4,13,20,cooperative
35,TGGCCGCACATGTACGGGTATGCATGTGCTTCCATA,9,25,16,4,13,25,cooperative
36,CCCCGCCCCGGCACGTGCGCGCGCGTGGTCTGCCAG,14,24,10,4,10,19,cooperative
37,GCGTGTTGCATGCTGCCTCGCACGTGAAGGCAGGGC,11,23,12,4,15,26,cooperative
38,GTGTGCGCGCGTGCGAGTGTGCGCGTGTGCAGTCCC,10,26,16,4,9,13,cooperative
39,TGAGCAACCACGCTGTCCATGTCCCACGAGGCCTAC,11,27,16,4,15,25,cooperative
40,CAGAGACCGCGTGTGGTCATGACACGTGCCTTCCCA,12,25,13,4,14,28,cooperative
41,CAAACAGCCACATGGAATGGCCATGTGTAGGTGTTC,11,24,13,4,13,23,cooperative
42,CCTGCTCCACGTGTGCCTCTCGCACGTGGCTCCCCA,10,25,15,4,10,20,cooperative
43,CCCCTGCGCATGTGGGCTGCCTGACATGTGCCACTC,11,27,16,4,11,22,cooperative
44,TGCGCGCGCATGTGAGTGCGCACGTGAGTGAGTGTG,5,23,18,4,9,14,cooperative
45,CCCGCGCGTGCGCGCCCCCGCCGCCGCGTGTGAGTG,7,27,20,4,7,12,cooperative
46,GGTCTCACCTCGTGGCCTAAACACGCGTCAGAGTGG,11,24,13,4,14,26,cooperative
47,GACTGTCACGTGGCGCCGGAGTTCACGTGACTCGTA,9,26,17,4,13,25,cooperative
48,AGTTCCTCATGTGGTTATAATCCATGTGTAGTAGTT,10,25,15,4,12,22,cooperative
49,ACGCACCACGTGGATGCTTTGCCACGTGCTCAGTTA,9,25,16,4,14,23,cooperative
50,CAGGACAGCGTGCACGGGGCAGGCGCGTGGTGTGTC,9,26,17,4,9,20,cooperative
51,GACCCAGTCACATGGGGAACCATGTGGAGGCCGAGA,11,23,12,4,13,25,cooperative
52,AAAAGGAGGCACATGCCTGCCACATGAGGAAAACCC,12,23,11,4,11,20,cooperative
53,GCTATCACATGGAAAAACTGTGCATGCGTGCGCACT,8,25,17,4,13,23,cooperative
54,GTCTGCACGTGTGCACACACATGCACGTGCACCTGT,8,26,18,4,10,15,cooperative
55,CCTAAACGCGTGTGGCCCAGGGCCATGTGGATGCCA,11,26,15,4,14,24,cooperative
56,TCTAATCCACGTGGGGAATAACATGCGGGCCTGCAG,10,24,14,4,14,28,cooperative
57,AGGCATTTCATGTGCATATGCACATGCACACAATAT,11,23,12,4,12,18,cooperative
58,CTCGGGCATGCGTTTTGGTTTACACGCGGCCAGGTT,9,25,16,4,14,26,cooperative
59,CCTGGGAGCCACGTGCTGGCCATGTGGCCAGGGACG,12,23,11,4,12,22,cooperative
60,CCCATGCAGCATGTGGTCCCACATGCAGGGTGAAGA,12,22,10,4,12,21,cooperative
61,GAAGCCATGTGTCCCCAGCAGGACATGTGGGAGGAG,8,26,18,4,12,21,cooperative
62,CTGGGGCATGTGCCTCTCCTGCACATGTGTGTCTGC,9,24,15,4,10,18,cooperative
63,TCTGGAAGCCATGTGGAGGCCACATGGAATGCAAGT,12,23,11,4,13,22,cooperative
64,CCGCGGGCCCATGTGAGCGCCATGCGGCGCCGCGCA,12,23,11,4,10,17,cooperative
65,GGCAGGCCGCGTGGCCGGGTCCCATGTGCTCCACCT,10,25,15,4,12,26,cooperative
66,TGAACGCGCACGTGGAGGCTCACGTGGAGGAGGAGG,11,23,12,4,12,18,cooperative
67,CCCCCCACGTTATCACTGGCCCCCATGAGGGAGACA,8,26,18,4,15,24,cooperative
68,GTCAAATGACATGTGGCTAAAGCATGGAAGGATATC,12,23,11,4,13,26,cooperative
69,GACTGAGCCCCACGAGGCAAGCACGTGTCTGTTCCT,13,24,11,4,14,25,cooperative
70,TGCCAGCATGTGGATTGCAGTCCCATGTGCCTGGAT,9,26,17,4,12,21,cooperative
71,AACCTCAACATGTGCTTTGACCATGTGCCTCCCAGG,11,24,13,4,13,23,cooperative
72,GGAGGCCACGCGCGGCGATTTGCCACGCGCCGCGTC,9,26,17,4,12,19,cooperative
73,GTGAATACATGTGGGAGGCTCACATGTGACACCAAG,10,23,13,4,14,24,cooperative
74,TTGCACGCACGCGTACCCCCCCGCACGCATGCGCAC,10,30,20,4,10,15,cooperative
75,TGCAGGGTCACATGGGGAAGCCACATGGGATGATCA,11,24,13,4,12,22,cooperative
76,GGTCGCCATCACGTGACTCCCATGCGCCCTGGCCCT,12,23,11,4,12,26,cooperative
77,CGCTGCCGCGTGGCCCTCCTCGCGCGTGCACGGCAG,9,25,16,4,10,20,cooperative
78,CTTCCCCGTCACGTGAGCCCCACGCGGGGCCAATGG,12,23,11,4,15,24,cooperative
79,CCCCGAAGCACGCGCGCACCCACGCGGCCGCGGCTT,11,23,12,4,10,17,cooperative
80,CCTGCCACACGTTTCTTCCCCCATGTGGTCCTCATC,10,24,14,4,12,25,cooperative
81,CTGCTCCATGTGTCCCCTCGGCCACGTGGCCCCAGC,9,25,16,4,12,22,cooperative
82,GCGACTGCGCATGCGGGAGCATGTGATGAAGAATGT,10,22,12,4,12,23,cooperative
83,TTTCGATACGCATGTTGAACCCGCGTGTAACCCCAC,13,24,11,4,13,27,cooperative
84,TCTCTGCCACGTTTTGACCCAGCATGTGGCCCTCAT,10,25,15,4,14,27,cooperative
85,CCGGCCGTCACGTGGGAGGTCACGTGGGTGGTTTGT,11,23,12,4,12,19,cooperative
86,TTACAACACGCATGCGCCAAGCCCACGCGGTTCCGG,13,26,13,4,14,24,cooperative
87,ACCCAAGCCCTCGTGCTCCCACGCGGGTTTCACCGA,12,22,10,4,13,27,cooperative
88,AACATATACCACGCTGTTGTCATGTGGTCAGCTATG,12,23,11,4,15,25,cooperative
89,CACATTTCACGTGCTCAGCAGCCACGTGGTTACTGT,10,25,15,4,14,25,cooperative
90,CAGCAGGGCATGTGTTTATACCATGTGGCTAAATGC,11,24,13,4,13,24,cooperative
91,GGGCGTCTGCGCATGCGCACTCCCACGCGGACGATG,12,26,14,4,12,24,cooperative
92,GCCCCAACCCACGCGGAGGCCACGTGCACAGCTCCA,12,23,11,4,13,25,cooperative
93,CGACTGGCCACGCCCCCTGCCCACGTGCCACCCAGG,11,24,13,4,11,18,cooperative
94,ATGTGGACAGCGTGCTGGGGCACGTGACTGGAGGAA,11,23,12,4,11,23,cooperative
95,GGTGCACCCGCGTGGCGGTGCATGCGGTCGGGGTGC,11,23,12,4,10,19,cooperative
96,GGAATGCGCATGCGCAAAAGCCACGCGGGCGAACAC,9,24,15,4,11,23,cooperative
97,TGCGTCACGTGAGGAGGTGGTGTCACGTGACCTGTC,8,26,18,4,12,19,cooperative
98,AGATGCACATGGAAATATGAGAGCACGTGGAAGGGA,8,26,18,4,12,24,cooperative
99,AGGAATACGCACATGTGTACGTGTGTAGGCATGTGC,12,32,20,4,12,19,cooperative
100,GTTGGGAGCGCATGCGACCCCATGTGACTCGGGTCA,11,23,12,4,14,27,cooperative
101,GCCGGCTCTCACGTGGAGGTCACGTGACGGATGCTG,12,23,11,4,13,23,cooperative
102,ACAACTGACACATGTTCCTGCCACGTGGTGCTAAGA,11,24,13,4,16,27,cooperative
103,ATCTCCATGCGTTCTGATCAAGGCATGTGATGGTGG,8,26,18,4,14,25,cooperative
104,TGGCGGGCGCGTGGTGGGAACCGCGTGGAACCGAAG,10,24,14,4,9,15,cooperative
105,TGTCCTTGCACGCGCTGGCGCACATGCACTCACACT,11,23,12,4,12,22,cooperative
106,CCCCGTCACGCGCCGCCAGCGGCCATGTGCCAGGCC,9,26,17,4,11,21,cooperative
107,GTCTCTTGGCGCGTGGGGACCGCGTGGAAGTGCCTT,12,23,11,4,13,22,cooperative
108,AAACTCTGACCATGCTTCACGCACATGTGGTGGAAA,13,24,11,4,14,28,cooperative
109,TGGTGCCACGCCCCCACCCCGCCCACCACGTGACCC,9,29,20,4,9,15,cooperative
110,CCTCATATTAACGTGTTTGGCACATGTTGCCTAAAA,12,23,11,4,14,27,cooperative
111,TGCCTTTGGCGCGTGCGCACCACGTGACCCAGGAGT,12,23,11,4,12,24,cooperative
112,TACAAAGGCATGCGGCAAGACCACATGATGTTTATT,11,24,13,4,14,25,cooperative
113,GGTCAGACACGAGGTCGCGGAGCGCGTGGCACACCC,10,25,15,4,11,24,additive
114,GCCCTCACGTGCTCACTCACACGCACGCACGCAGGC,8,20,12,4,11,17,additive
115,GCCCCATGTGGCCGAGCCAGGGACCACATGCGTCCC,7,27,20,4,12,26,additive
116,CGCTCCACGTGCGCCGTGTTTACCCACGTGATGCGC,8,27,19,4,13,23,additive
117,ATGGGCCACACGCTGTCCCAGCACATGGTGGCAGGG,9,24,15,4,12,23,additive
118,ACGCCCACGCGGCATACAGGCGCGCACGTGCACACG,8,27,19,4,11,19,additive
119,TGTCTTCTCCACGTGTCTTCACATGGCCTGCCCTCT,12,22,10,4,12,23,additive
120,CGGCCACGTGACGCGCGACGGGGCCACGTGATGAGC,7,27,20,4,11,17,additive
121,GTTGCCATGTGCGAATGGCGCCCCCTCGTGTTGTGG,8,27,19,4,13,21,additive
122,GCCAAAGACATGTGCGACCGCATGTGGCTGCTGCAT,11,23,12,4,13,23,additive
123,GAGTCCACGTGCACCCCACCCAGCACATGCTCCTGC,8,26,18,4,12,22,additive
124,CGCGTCGCACGTGATGGAACCCGCATGGACCCGCGA,10,24,14,4,12,21,additive
125,CGAGGCCCACGCGAGGCCGCCCACGAGGAGTTTCCG,10,24,14,4,11,18,additive
126,AGTCCATGTGGCTTGAGTCGCAGCCATGTGACTCAG,7,27,20,4,14,25,additive
127,CGGGACACGAGGCGATCAAGGGAGCACGCGCGCCAC,8,27,19,4,11,22,additive
128,AGGTCCACATGTTGCATCTGGACCACGTGTTTAAGC,8,26,18,4,16,28,additive
129,ACACACCCTCACATGCCCCCATGTGGCCTCTTACTA,12,22,10,4,12,21,additive
130,CGCGCCACGCGCTCGGGACGGTGCCACGCGGCGGTG,8,27,19,4,11,17,additive
131,TGGGAGCCTCGTGGCCCCAAGCCACATGGCTGGCAG,10,25,15,4,14,23,additive
132,GCACCATCCCACGTTTTCTCACATGTAACTGGCTGG,12,22,10,4,14,27,additive
133,CCCTGGGGCCACGCGCCGCCACGTGCCGCCACAGGG,12,22,10,4,10,19,additive
134,CTCCACACACGTGCACGGCATGCATGCGCGCGCGCA,10,25,15,4,11,16,additive
135,CGCACCTCGTGCAGTGCCCACAACACGCGGCAGTCC,8,26,18,4,12,23,additive
136,TGAAGCGCATGTGTGTGCCCGCACACGCACATACAC,10,24,14,4,12,20,additive
137,AAAGCCATGTGTAACACACATACCATGCTGATCAGG,8,26,18,4,13,25,additive
138,CCAGCCACGTGTTCCCAGGTGCCCACGCGGGCCAAG,8,26,18,4,12,22,additive
139,TCTGGGTGTCACGTGGAGTCACATGGGGTCAATGTG,12,22,10,4,12,20,additive
140,CGTGGGCCGCGTGGGCCCAGCCTCGTGGGCTGAGTT,10,24,14,4,11,21,additive
141,CCCACACACATGCTCACGCCCACACATGCACACTCA,9,25,16,4,9,15,additive
142,CCCCGCGCACGTGCACAGCACCGCGTGCATCAGCCC,10,24,14,4,10,18,additive
143,CCTGCCACGAGGCCGCAGTATAACCGCGTGGCCCGC,8,27,19,4,14,27,additive
144,CCTCAGCCATGTGGGTGGGCATCACGTGATCTGCTG,10,25,15,4,13,26,additive
145,CGCCCATGCTGGAAACTCTACACCCATGTGTAACCG,7,27,20,4,14,26,additive
146,GGAAATGCGCGTGGAGACTGGGCGCGTGCAATGGTG,10,25,15,4,12,21,additive
147,ATGTGCACACATGCACACACGCACATGCCGCAGCTC,10,24,14,4,10,15,additive
148,TGCGTGCGTGCGTGCGTCCGTCCTCGTGCTCGCGCA,5,25,20,3,7,12,additive
149,CTCCCCCCGCGCGTGGCACCCACGTGGGGCTTTCTC,12,23,11,4,11,21,additive
150,CTTCCACGTGGTTTTCAGGCTAACCATGTGGTTTTT,7,27,20,4,15,24,additive
151,CTTCCCCCATGTGGTCCTCATCACATGTACATTGTC,10,24,14,4,11,22,additive
152,AAGGCACGTGCATTCTGGTCATCCCACGCGGGGAGC,7,27,20,4,15,28,additive
153,CTGGCGGCCGCATGGAGGCCCACATGCCTTACGCTC,11,23,12,4,13,25,additive
154,CGGGTCACGTGCCCAAAACACGCTCACGTGATGCGC,8,27,19,4,13,24,additive
155,ACAGCGCGCGTGCTGTCTTTCCCATGTGGTGGGGTT,9,25,16,4,13,24,additive
156,CAGTCACATGGTGTCAGCCGTGCCCACGTGACCAAG,7,27,20,4,13,24,additive
157,GCCGCGCAGCATGGAGCGGTGCCACGTGTTGGCCAG,10,25,15,4,12,24,additive
158,CCTCCCCACGTGGGACCCTCCCCACGTGGGACCCTC,9,25,16,4,10,14,additive
159,GCGGCGACCACGTGTTTGCCGCATGTGGTATCTGGG,11,24,13,4,14,29,additive
160,AGAAGGGTGCACGCTGAGCCCCCACGTGGGTAGCGG,12,25,13,4,13,25,additive
161,GCGGGCCATGTGACCCGGTTGGTCACGTGGCTGAGC,9,26,17,4,14,27,additive
162,TGCTGCCCCCGCGTGCAGCGCCCGCGTGCACCGGGC,12,25,13,4,10,17,additive
163,TGTGCATGCATGTGTGTGTACATGTGTGCGTGTGTG,11,23,12,4,8,11,additive
164,TACGCACATGTGTACGTGTGTAGGCATGTGCTGTGG,7,27,20,4,11,18,additive
165,CAATGCGCATGCGCTCTCCGCCACGCGCGCCCAGAC,8,24,16,4,12,20,additive
166,ATACACACACATGTGCATCCATGTGCACACACATAC,12,22,10,4,9,13,additive
167,CTACATCACGTGACGGCCAGTACGCGTGGGATTTGG,9,25,16,4,15,28,additive
168,GTATCCAGCACGCGTCGCAGCAGCGTGCGCGGCGTG,11,24,13,4,12,19,additive
169,CCCACAAACACATGCACTGACCACGTGGTCATCCCC,11,24,13,4,13,25,additive
170,TTTGCCCACGTTACGTCATAGACATGCGCGCGACGC,9,25,16,4,13,24,additive
171,AGCTCCTCGTGGCGGCCGACGCGCATGCGCAGCGCC,8,24,16,4,13,23,additive
172,CAAATCACATGGCCCACCCTGGCCACATGGGAGGAT,8,26,18,4,12,21,additive
173,TGTGCAGTGCACGTGAGAGCACGTGGCGGCTTCTGG,12,22,10,4,12,22,additive
174,TTTCTCTCCCATGCGGTAGCATGTGTGACAGCAGGA,12,22,10,4,15,24,additive
175,TGAGCGGGCGCGTGCGGCGGCCACGTGGGCGAGGAG,11,24,13,4,10,19,additive
176,CAACCACATGCACACCTGGACTCGCACACGCCCACG,7,27,20,4,12,22,additive
177,AGCCCCCACGTGGCCAGTCCCCCACATGGCCAGCCC,9,25,16,4,11,17,additive
178,TGCCCCCACGTGGCCACCGCTCCACATGGCCCCCTT,9,25,16,4,11,20,additive
179,TGGCGCCCGCGTGGCCACTGCGCATGCGGACCCGGC,10,23,13,4,11,21,additive
180,CCACCTCGTGGCCAAGAGGGAGACCGCGTGCCTTTC,7,27,20,4,14,25,additive
181,AGCGCGCATGCGCCTATGCTCCCACGCGCTCTCAAT,7,25,18,4,12,21,additive
182,CCGGTGCAACGTGCAGCAGGGCAACGTGCGCGAGAC,10,25,15,4,11,20,additive
183,GCGAGTTCCATGTGCGGCAGACACGCGCTCACACTT,11,24,13,4,14,27,additive
184,ATTCAGGCCATGCGGGCAGCCACGTGCAAAGGCCCT,11,23,12,4,13,24,additive
185,CTCAGAGCCACGCCCCCTTATGGTCACGTGAGGCGC,11,27,16,4,15,26,additive
186,GGCATCACGTGCGCAGAGCGGGTCACGTGGGCGCGG,8,26,18,4,11,21,additive
187,GAAGGGTCATGTGGAGAAGGCCACGAGGCCCAGCCC,10,24,14,4,13,24,additive
188,CGCCGGGTCACGTGGCGCGGTCACGTGGCGCGCAGC,11,24,13,4,10,17,additive
189,CGGGGCCGTCACGTGGGGCAGCGTGGGCCGCTGCCT,12,22,10,4,11,20,additive
190,CCCGGCCACGTGGGCCTCCGAACCACGAGTCATGCG,9,26,17,4,14,26,additive
191,CTGTCCACATGTCCCACACGGTGCACGAGGATGTCA,8,26,18,4,13,21,additive
192,GGCAGCTCGCGTGTGTGGGCGCACGTGCGTGCAAGT,12,24,12,4,11,19,additive
193,ACACATTTCATGTGGAAATGCCATGTGCGGTCATCT,11,24,13,4,13,23,additive
194,AGTCAGCGTGGTCTTCCCGTGGTCCACATGGCCGAT,7,27,20,4,14,24,additive
195,CCGGAACACGTGCACGCGCGGTCACGTGGCCCGGCC,9,25,16,4,11,21,additive
196,ATGTGTGTGCACACGTGCAGACATGTGTCCCCCGGC,14,24,10,4,12,18,additive
197,AGTCGTCTGCACATGCGGTTCTGCATGTGGCCCCCA,12,26,14,4,13,23,additive
198,CCCCGGACACGCGGTGAGCGGACATGTGCCGGCCGC,10,25,15,4,11,21,additive
199,GTCTGCCGCGTGGACCAGTGAGCACGTGCTCCCGGG,9,25,16,4,12,28,additive
200,CTGTCTGTAACGTGGAGGTGTCACGTGCCAAGGGCT,11,24,13,4,14,24,additive
201,TCTTGCACGTGTCTTTTGGTGAACATGTGTGTACAT,8,26,18,4,14,22,additive
202,TCCAGAACACGTGATGGGAAGCATGTGGGTATGTAT,10,24,14,4,14,25,additive
203,AAGCCATCACATGGCTCTGCGCCACGTGCTCAGTAG,10,25,15,4,14,25,additive
204,CCCCCACGTGCCCCGCATATTTTCCACGCGGCTGCG,7,27,20,4,13,23,additive
205,CGGACACCAACGTGCTGACGCATGTTCATTAGCGAG,11,23,12,4,16,30,additive
206,CTTTAGTGACACGTGACACCATGTGCTGCTGACGCC,12,22,10,4,13,21,additive
207,TCTAGACCACATGGCAGCAGGCATGTGTGTCTGCGT,10,24,14,4,14,23,additive
208,TGTGCACACGTGTGTGTGCATGCACGCGTCTGCACC,9,25,16,4,9,15,additive
209,AATCCATGCATGCTGGTGGGACAGCATGGGTAGCCG,11,25,14,4,14,22,additive
210,AAACAGCATGTTGCTCCCCACTGCCTCGTGTTGTCT,9,27,18,4,13,26,additive
211,TGCCCACGTGCCTGCAACAGTGGCCACGTGGGGCCC,7,27,20,4,11,19,additive
212,GGTAGGACCGCGTGATCGCGCACGTGACCGCCCGCC,11,23,12,4,13,21,additive
213,GAGAAACCATGTGTAAAAGGGGCACGTGGCCCTGCC,10,25,15,4,14,27,additive
214,CTCCCCCAACCACGTGGCAACCACGTGCTCCCAGCG,13,24,11,4,12,18,additive
215,ACAACACGGCATGGAGCAGCTCCACATGGACACCCC,10,25,15,4,13,22,additive
216,CCCCAACACGTGCTTATGTAACCACGTGGAAAGCGG,9,25,16,4,15,26,additive
217,ATTACAACACGCATGCGCCAAGCCCACGCGGTTCCG,14,27,13,4,14,24,additive
218,AATCCCACCATGTGGGAGGCCAACGTGGGAGGATCA,11,24,13,4,13,23,additive
219,TGCAATCCATGTGCTGCGGAACCATGCTGTGGGACC,10,25,15,4,13,22,additive
220,GCCCACCACGCGCTCCGGGTAGCACGTGTCCAGCCC,9,25,16,4,12,24,additive
221,AGCTGCATGTGTTGCAATCCGCTCACATGGGGCCTG,8,26,18,4,14,26,additive
222,CATCCATGTGAGAGTGTTTTTGTGCATGTGTGGGCT,7,27,20,4,11,19,additive
223,GGCACGCGTGCGGGCGTCACCGTGCGCGTGCGACCC,7,27,20,4,10,17,additive
224,ACGCAGCGTGGGACCATGACGCGCCACATGCGCAGC,7,27,20,4,11,21,additive
225,GCATGCAGCCACATGGCCCCACATGGTGCAGTTCTG,12,22,10,4,12,19,additive
226,CGGTGCGCGTGCGCGGTAGGAGACACGAGGGTAGTA,8,26,18,4,10,20,additive
227,CACCCTGTCACGTGGTTAAGCACGTGAGTTCTGCAG,11,23,12,4,15,25,additive
228,CAGCACAAGCATGCGTGCGCGCGTGCGCGCGCACAC,12,22,10,4,9,14,additive
229,GCCGCGGCCCACGCGGCGGGAGCACGCGGAGGCCTT,12,25,13,4,9,17,additive
230,AGAAGTCACGTGGCAGCCGGAAAGCGTGGCGGCTGC,9,25,16,4,13,23,additive
231,GATACCATGTGGAGAGAGAGAAGCCACGTGGAAGAC,8,27,19,4,13,20,additive
232,CGGAAATCGCGTGACTCGCCCCCCTCACGTGGGCCG,8,28,20,4,13,24,additive
233,ACCTACCATGTGAGCTGGGCACCCACGTGGGTCTCA,9,26,17,4,14,26,additive
234,ACCTCGCATGTGGCCCACAGGCCACGTTCCACTACC,9,25,16,4,14,27,additive
235,CGTGGTCACGTGACCGTCACTTCACGTGACCGCGCG,9,25,16,4,12,17,additive
236,AGCGGCCACGTTGATCTGCGATACGCGTGTTTGCCC,9,26,17,4,15,24,additive
237,CGCAGTCACGTGACCAAACGTCCACGTGACCGGTAC,9,25,16,4,13,22,additive
238,ATCACCACGTGTCAAGGGAGAGACCACGCGGAGGCA,8,27,19,4,13,22,additive
239,CAGCAGACACGCGCTTCAGGCCCACATGGCGCAGGA,10,25,15,4,13,22,additive
240,CCAGAGCACATGGTTAAGTCTGCCGCGTGGACCAGT,9,26,17,4,16,30,additive
241,CCCGAATCCCATGTGACCCCATGCTGTGCACAGTCA,12,22,10,4,13,24,additive
242,CCCTTGTCCACGTGTCCATCACATGCACATTTCTGC,11,28,17,4,11,24,additive
243,GAGCAGCATGTGTGGGTGCTCAGCATGTGTGAGCTG,9,26,17,4,10,16,additive
244,GCGCGGGCCATGCGTGCGCACACGCGCGCCCGCCCG,11,21,10,4,9,18,additive
245,GTGCGCGCACGCGCGCCCCTGCCGCGTGCAGCCGCC,10,25,15,4,9,15,additive
246,GTGTTCGCGCGTGCGTGCTTGCACATGCGCGCCACC,10,24,14,4,11,19,additive
247,CACGCGCCACGCTCCCAGCGCCATGTGCGGCCGATC,10,24,14,4,13,22,additive
248,CGACGCGCACACGCGGTCGCACGCGGCCCCCCGAGC,10,22,12,4,10,17,additive
249,GCGGCAGCCCCACGCGGCGGCCACATGCAGCGGCGT,13,24,11,4,9,16,additive
250,CGCGCACCCCGCGTGCCTCCACGTTCCACACGTAAC,12,22,10,4,12,21,additive
251,CTCCACTCACGTGCCCGTAGCCAGCATGGCCGGCCC,10,25,15,4,13,23,additive
252,CAGTCGTCCACGCTGCGCAACCACGTGCGCCTGCAC,11,24,13,4,11,21,additive
253,GGAACACACATGCTCACACACATGCATGCACGCTGG,9,21,12,4,11,15,additive
254,CTGCACACGTGACCGCACTGTAGCACGTGATGGCGC,8,26,18,4,13,23,additive
255,ACAGCCACGTGGGTGTTAGAAGCCACATGGCCCATC,8,26,18,4,14,23,additive
256,ACGGCCATGTGGCCTTGGACCGTCCACGTGGCCTTG,8,27,19,4,13,21,additive
257,GGGCGCCACGTGGCCCCGCCCCCGCCGCGTGCGCAT,9,28,19,4,8,15,additive
258,TCACCACATGCCACAGATCAAGACCACGTGCTCCTG,7,27,20,4,13,23,additive
259,CCACACACGTGCTCAAGCTCACAACACATGGATAGT,8,27,19,4,15,21,additive
260,CGAGCGCACGCGCATACGTTGACCGCATGCGACCCC,9,26,17,4,12,21,additive
261,GGGACCCATGCGGGACGGTAGACAGCGTGGGCAGGG,9,26,17,4,12,25,additive
262,TCCGGACCACGTGACCCCGCCCACGTGACGTCCCCT,10,24,14,4,10,16,additive
263,TCTTGGCATGTGGAGTCTAGCACCACATGAGAAGGG,9,26,17,4,15,26,additive
264,TGACGTCATGTGGCCCGTGTCGCCACGTGCTTCCAG,9,26,17,4,13,24,additive
265,CATTTCCGCCACGTGACCCGCGCATGCGCCTGCTTG,12,23,11,4,12,25,additive
266,GGGGCGGCCATGCTGCCAGGCACATGTAGGGGCAAG,11,23,12,4,13,20,additive
267,CCATTAGGCCACGCGGCCGCACGCGGGTGCTAATTT,12,22,10,4,14,23,additive
268,TTGCCACGTGACCCGCTCCGCATACACGTGACCAGC,7,27,20,4,14,23,additive
269,GCCGGGCCATGTGCTCAGCGCCCGCGTGGAGGTGGG,10,25,15,4,12,25,additive
270,TAGCCATGTGGCTAATTGTTTTTCCACGTGCTGCCT,7,27,20,4,15,25,additive
271,GGTGAGTCCACGTGATTAGTCACATGGTTGATGACA,11,23,12,4,13,23,additive
272,GGGTGGACCACGCGAGTCAGCACGCGGCTGTCTATT,11,23,12,4,14,28,additive
273,AGGGACACGAGGGCGCCGGGCCTGCACGTGGGACCC,8,27,19,4,11,23,additive
274,CCGGGTCACGTGGGTCCAGGGTCACGTGCCGCTGCG,9,25,16,4,11,20,additive
275,CCCCTCTCACGTGACTCGGTGCCGCGTGCTCCCAGG,10,25,15,4,12,24,additive
276,GAGGCCACCATGTGACAGAGCACATGGAACATGCAG,11,23,12,4,11,23,additive
277,CGTATGATGCACATGCACCCATGCTGTGTGAGCTCT,12,22,10,4,13,21,additive
278,AGGCCCGCACGCGGGCTCGAGCCGCGTGGAATGGTA,10,25,15,4,14,26,additive
279,CGAGCACGTGGGGTTGACGGGCGCCGCGTGGAGGCA,7,27,20,4,11,23,additive
280,GGTAGTCACGTGTCCGCGGGTGTCACGTGCTCGCGT,9,26,17,4,12,21,additive
281,GCGTCCACATGGCTTCAGGTGTTCACATGGCAGTAA,8,26,18,4,14,24,additive
282,CCCCCTCCACGTGACGACCCAGGACACATGCGCACC,10,27,17,4,13,23,additive
283,CACACAGCACATGCCTGATCACACGTGGGCGCTGGG,10,24,14,4,13,24,additive
284,GACGCACGTGCCCAGAGGAAGGGCCATGTGAGGACA,7,27,20,4,12,24,additive
285,GGGGCCGCGTGCCCGGGGCGGGGCCACGCGCGATTG,8,27,19,4,11,17,additive
286,GCCCCACGAGTCCCAGAGTGATCACATGCGGTACAT,7,25,18,4,13,26,additive
287,CAGGGCCCTCGTGTGCTTCCAGCACGTGAATCTGGG,10,25,15,4,15,29,additive
288,AGCGCGCATGTGCACCTCAGCCGGCCCACGAGGCCA,9,29,20,4,13,25,additive
289,CGAGCTGCACGCACACTCTCAACACGCGCCACCTCG,10,25,15,4,11,22,additive
290,TTCTCAGCCCACGTGTTCTCCCCCACGTGGGGTAGC,12,26,14,4,13,21,additive
291,TGCTGCCCCCTCGTGGCCGCACGTGTTACCGCAGGC,12,22,10,4,13,24,additive
292,TTCTTTCCCCACGTGGGTCCACGTGAGGCTCTGCCC,12,22,10,4,13,24,additive
293,TTTCGCGGCGTGGGCGGGGCCAGCACGCAGGTTGCA,9,24,15,4,11,23,additive
294,TGGTGGCCACGTGGGTGGTGACACGTGCCTGCTTGC,10,24,14,4,11,19,additive
295,CCGCCAACACGTGCGCGGACGCACGCACGCACTCCT,10,22,12,4,12,20,additive
296,TGTGCATGTGTGCGCGCCTGTGCTCATGCACGCCCC,7,25,18,4,10,17,additive
297,CAGGACGCGTGTGCCGGCCACAAGCGCGTGCACAGG,10,27,17,4,11,22,additive
298,CTTCGCGCATGTGACAGGCCCCAACGTGCACGATCT,10,25,15,4,15,28,additive
299,CACGTGATCACGTGCGTGGTCACATGGACCGGCCCA,11,23,12,4,11,24,additive
300,CTCACCGCACATGCGCGGAGCCGCGTGCGCAGCTGC,10,24,14,4,13,22,additive
301,ATAACTCCATGTGCTCATCGCCATGTGGTTTCTGCT,10,24,14,4,14,25,additive
302,CAAACCCTCATGTGCTCCTACCATGTGCTAGGCAGT,11,24,13,4,13,23,additive
303,CACTGAGCATGCGCCCCCATACGCGTGTGCCGCGCG,10,26,16,4,12,22,additive
304,CGAGCCGCGTGAAACGCAAGGCCCTCGTGTGTGCGC,8,26,18,4,13,25,additive
305,CCGCGAGCCCACGAGGCCCCGCGTGGTGTCACTGGG,12,22,10,4,12,22,additive
306,CATTTGCATGCGTTTGTGCATGCATGTGTGTGTCTG,9,25,16,4,9,14,additive
307,TTACACATCACATGGGGAGCAGCATGCTCCCACTGT,11,25,14,4,13,23,additive
308,CTGGGCCGGGGCGTGGCCACACGTGTGCTGGCTCTG,12,22,10,4,10,19,additive
309,ATCTGTAGCATGTGGCGAGCCCCCATGTGAGTGTGT,11,26,15,4,13,21,additive
310,TGCCTGACCATGTGTCAGGCCACGTGTCTGGTATTG,11,23,12,4,15,26,additive
311,CCTGACCACGTGGCTACTTTTCCCCCACATGCGGCG,9,28,19,4,14,27,additive
